111111111111111111111111111111111111111111111111
100000000000000000000000000000000000000000000001
100000000000000000000000000000000000000000000001
100000000011111111111111111111111111110000000001
100000000010000000000000000000000000010000000001
100000000010000000000000000000000000010000000001
100000000010000000000000000000000000010000000001
100000000010000100000000000000000000010000000001
100000000010000000000000000000000000010000000001
100000000010000000000000000000000000010000000001
100000000010000100000000000000000000010000000001
100000000010000000000000000000000000010000000001
100000000010000101010000000000000000010000000001
100000000010000000000000000000000000010000000001
100000000010000000000000000000000000010000000001
100000000010000000000000000000000000010000000001
100000000010000000000000000000000000010000000001
100000000010000000000000000000000000010000000001
100000000010000000000000000000000000010000000001
100000000010000000000000000000000000010000000001
100000000011111111111111111111111111110000000001
100000000000000000000000000000000000000000000001
100000000000000000000000000000000000000000000001
111111111111111111111111111111111111111111111111