         111111111111111111
     1111100000000000011
11111000000000100000001
10010000000001110000001
11011110000011011000001
  100010000000000000001
   10001000011011000001
  100000000001110000001
11000000000000100000001
10000000000000000000001
10000000000000111100011
1000000000000011111011
100001111111111   101
10001             101
10001             101
10001             101
10001             101
10001             101
10001111111111111 101
1000000000000111111011
11110000000000111110111
10000001100000111110111
10000001100000111100011
10000000000000000000001
1000000000000000000000111
10000000001111000000000001
111111111111111111111111111
