




WE      ./textures/wall_w.xpm
NO              ./textures/wall_n.xpm
EA ./textures/wall_e.xpm
SO            ./textures/wall_s.xpm

F          150,150,100                       
            C 100,100,150
1111111111111111111111111111111111111111111111111
1000000000000000000000000000000000000000000000001
1000000000000000000000S00000000000000000000000001
1000000000000000000000000000000000000000000000001
1000000000000000000000000000000000011000000000001
1000010101010000000000000000000000001100000000001
1000000000000000000000000000000000000000000000001
1000000000000000000000000000000000000000000000001
1000000000000000000000000000000000100000000000001
1000000000000000000000000000000000010000000000001
1000000000000000000000000000000000000000000010001
1000000000000000000000000000000000000000000010001
1000000000000000000000000000111111111111111111111
1000000000000000000000000001                     
1000000000000000000000000000111111111111111111111
1000000000000000000000000000000000000000000010001
1000000000000000000000000000000000000000000000001
1000000000000000000000000000000000000000000000001
1000000000000000000000000000000000000000000000001
1000000000000000000000000000000000000100000000001
1001001001001000000000000000000000000100000000001
1000000000000000000000000000000000000000000000001
1000000000000000000000000000000000000000000000001
1111111111111111111111111111111111111111111111111